Name,RollNo,Maths,Physics,Chemistry,IP,English,Total,%,Grade
Clint,6,36,50,40,42,38,206,82.4,A2
Sean,10,41,43,35,38,41,198,79.2,A2
Andrew,1,45,47,41,44,40,217,86.8,A2
Michael,9,45,47,41,44,40,217,86.8,A2
Sam,12,45,47,41,44,40,217,86.8,A2
Tony,3,46,41,40,46,41,214,85.6,A2
Athena,2,48,45,45,43,42,223,89.2,A2
Alex,8,48,50,40,46,45,229,91.6,A1
Thomas,11,48,48,40,46,45,227,90.8,A1
Paul,13,48,45,45,43,42,223,89.2,A2
Laura,5,50,46,50,41,43,230,92.0,A1
John,7,50,46,50,41,43,230,92.0,A1
